....?.#.
..?#.##.
?#..?#..
.#.?...#
?.#.##?.
.###..#.
..?.###?
##...?..