....?.#.
..##.##.
?#..?#..
.#.#...#
?.#.#?#.
.###..#.
..?.#.##
##...?..