....?.#.
..??..##
??..?#..
.#.?...?
?.#.#?#.
.##?....
...##.#?
##...?..